"filename", "language", "HTML (Twig)", "comment", "blank", "total"
"d:\Documents\WILDCODE\projet-3\2022-03-php-remote-1283-montbeliard-cite-libre\templates\admin\base.html.twig", "HTML (Twig)", 30, 1, 2, 33
"d:\Documents\WILDCODE\projet-3\2022-03-php-remote-1283-montbeliard-cite-libre\templates\admin\classe\_delete_form.html.twig", "HTML (Twig)", 4, 0, 1, 5
"d:\Documents\WILDCODE\projet-3\2022-03-php-remote-1283-montbeliard-cite-libre\templates\admin\classe\_form.html.twig", "HTML (Twig)", 5, 0, 1, 6
"d:\Documents\WILDCODE\projet-3\2022-03-php-remote-1283-montbeliard-cite-libre\templates\admin\classe\edit.html.twig", "HTML (Twig)", 8, 0, 6, 14
"d:\Documents\WILDCODE\projet-3\2022-03-php-remote-1283-montbeliard-cite-libre\templates\admin\classe\index.html.twig", "HTML (Twig)", 41, 0, 7, 48
"d:\Documents\WILDCODE\projet-3\2022-03-php-remote-1283-montbeliard-cite-libre\templates\admin\classe\new.html.twig", "HTML (Twig)", 7, 0, 5, 12
"d:\Documents\WILDCODE\projet-3\2022-03-php-remote-1283-montbeliard-cite-libre\templates\admin\classe\show.html.twig", "HTML (Twig)", 24, 0, 7, 31
"d:\Documents\WILDCODE\projet-3\2022-03-php-remote-1283-montbeliard-cite-libre\templates\admin\home\index.html.twig", "HTML (Twig)", 5, 0, 3, 8
"d:\Documents\WILDCODE\projet-3\2022-03-php-remote-1283-montbeliard-cite-libre\templates\admin\include\_navbar.html.twig", "HTML (Twig)", 69, 0, 1, 70
"d:\Documents\WILDCODE\projet-3\2022-03-php-remote-1283-montbeliard-cite-libre\templates\admin\include\_search_form.html.twig", "HTML (Twig)", 8, 0, 3, 11
"d:\Documents\WILDCODE\projet-3\2022-03-php-remote-1283-montbeliard-cite-libre\templates\admin\manage_users\_delete_form.html.twig", "HTML (Twig)", 4, 0, 1, 5
"d:\Documents\WILDCODE\projet-3\2022-03-php-remote-1283-montbeliard-cite-libre\templates\admin\manage_users\_form.html.twig", "HTML (Twig)", 11, 0, 1, 12
"d:\Documents\WILDCODE\projet-3\2022-03-php-remote-1283-montbeliard-cite-libre\templates\admin\manage_users\edit.html.twig", "HTML (Twig)", 8, 0, 6, 14
"d:\Documents\WILDCODE\projet-3\2022-03-php-remote-1283-montbeliard-cite-libre\templates\admin\manage_users\index.html.twig", "HTML (Twig)", 36, 0, 5, 41
"d:\Documents\WILDCODE\projet-3\2022-03-php-remote-1283-montbeliard-cite-libre\templates\admin\manage_users\show.html.twig", "HTML (Twig)", 44, 0, 9, 53
"d:\Documents\WILDCODE\projet-3\2022-03-php-remote-1283-montbeliard-cite-libre\templates\admin\question\_delete_form.html.twig", "HTML (Twig)", 4, 0, 1, 5
"d:\Documents\WILDCODE\projet-3\2022-03-php-remote-1283-montbeliard-cite-libre\templates\admin\question\_form.html.twig", "HTML (Twig)", 57, 1, 14, 72
"d:\Documents\WILDCODE\projet-3\2022-03-php-remote-1283-montbeliard-cite-libre\templates\admin\question\edit.html.twig", "HTML (Twig)", 8, 0, 6, 14
"d:\Documents\WILDCODE\projet-3\2022-03-php-remote-1283-montbeliard-cite-libre\templates\admin\question\index.html.twig", "HTML (Twig)", 42, 1, 6, 49
"d:\Documents\WILDCODE\projet-3\2022-03-php-remote-1283-montbeliard-cite-libre\templates\admin\question\new.html.twig", "HTML (Twig)", 7, 0, 5, 12
"d:\Documents\WILDCODE\projet-3\2022-03-php-remote-1283-montbeliard-cite-libre\templates\admin\question\show.html.twig", "HTML (Twig)", 35, 0, 7, 42
"d:\Documents\WILDCODE\projet-3\2022-03-php-remote-1283-montbeliard-cite-libre\templates\base.html.twig", "HTML (Twig)", 23, 1, 2, 26
"d:\Documents\WILDCODE\projet-3\2022-03-php-remote-1283-montbeliard-cite-libre\templates\classement\index.html.twig", "HTML (Twig)", 45, 0, 5, 50
"d:\Documents\WILDCODE\projet-3\2022-03-php-remote-1283-montbeliard-cite-libre\templates\components\game.html.twig", "HTML (Twig)", 412, 3, 47, 462
"d:\Documents\WILDCODE\projet-3\2022-03-php-remote-1283-montbeliard-cite-libre\templates\components\lastturn.html.twig", "HTML (Twig)", 15, 0, 1, 16
"d:\Documents\WILDCODE\projet-3\2022-03-php-remote-1283-montbeliard-cite-libre\templates\components\question.html.twig", "HTML (Twig)", 30, 0, 3, 33
"d:\Documents\WILDCODE\projet-3\2022-03-php-remote-1283-montbeliard-cite-libre\templates\components\roll.html.twig", "HTML (Twig)", 12, 0, 3, 15
"d:\Documents\WILDCODE\projet-3\2022-03-php-remote-1283-montbeliard-cite-libre\templates\confetties\index.html.twig", "HTML (Twig)", 16, 0, 6, 22
"d:\Documents\WILDCODE\projet-3\2022-03-php-remote-1283-montbeliard-cite-libre\templates\game\base.html.twig", "HTML (Twig)", 22, 1, 2, 25
"d:\Documents\WILDCODE\projet-3\2022-03-php-remote-1283-montbeliard-cite-libre\templates\game\collection.html.twig", "HTML (Twig)", 56, 0, 5, 61
"d:\Documents\WILDCODE\projet-3\2022-03-php-remote-1283-montbeliard-cite-libre\templates\game\index.html.twig", "HTML (Twig)", 25, 0, 7, 32
"d:\Documents\WILDCODE\projet-3\2022-03-php-remote-1283-montbeliard-cite-libre\templates\game\progress.html.twig", "HTML (Twig)", 6, 0, 4, 10
"d:\Documents\WILDCODE\projet-3\2022-03-php-remote-1283-montbeliard-cite-libre\templates\game_rule\index.html.twig", "HTML (Twig)", 47, 0, 11, 58
"d:\Documents\WILDCODE\projet-3\2022-03-php-remote-1283-montbeliard-cite-libre\templates\general_conditions_use\index.html.twig", "HTML (Twig)", 32, 0, 3, 35
"d:\Documents\WILDCODE\projet-3\2022-03-php-remote-1283-montbeliard-cite-libre\templates\home\index.html.twig", "HTML (Twig)", 65, 0, 5, 70
"d:\Documents\WILDCODE\projet-3\2022-03-php-remote-1283-montbeliard-cite-libre\templates\include\_diceanimation.html.twig", "HTML (Twig)", 35, 0, 1, 36
"d:\Documents\WILDCODE\projet-3\2022-03-php-remote-1283-montbeliard-cite-libre\templates\include\_footer.html.twig", "HTML (Twig)", 5, 0, 1, 6
"d:\Documents\WILDCODE\projet-3\2022-03-php-remote-1283-montbeliard-cite-libre\templates\include\_navbar.html.twig", "HTML (Twig)", 98, 6, 1, 105
"d:\Documents\WILDCODE\projet-3\2022-03-php-remote-1283-montbeliard-cite-libre\templates\include\_navbargame.html.twig", "HTML (Twig)", 50, 15, 3, 68
"d:\Documents\WILDCODE\projet-3\2022-03-php-remote-1283-montbeliard-cite-libre\templates\include\_questions.html.twig", "HTML (Twig)", 30, 0, 3, 33
"d:\Documents\WILDCODE\projet-3\2022-03-php-remote-1283-montbeliard-cite-libre\templates\include\_search_form.html.twig", "HTML (Twig)", 8, 0, 3, 11
"d:\Documents\WILDCODE\projet-3\2022-03-php-remote-1283-montbeliard-cite-libre\templates\layout\full-page.html.twig", "HTML (Twig)", 4, 0, 2, 6
"d:\Documents\WILDCODE\projet-3\2022-03-php-remote-1283-montbeliard-cite-libre\templates\layout\main-center.html.twig", "HTML (Twig)", 4, 0, 2, 6
"d:\Documents\WILDCODE\projet-3\2022-03-php-remote-1283-montbeliard-cite-libre\templates\legal_notices\index.html.twig", "HTML (Twig)", 32, 0, 3, 35
"d:\Documents\WILDCODE\projet-3\2022-03-php-remote-1283-montbeliard-cite-libre\templates\login\index.html.twig", "HTML (Twig)", 33, 0, 4, 37
"d:\Documents\WILDCODE\projet-3\2022-03-php-remote-1283-montbeliard-cite-libre\templates\questions\index.html.twig", "HTML (Twig)", 6, 0, 3, 9
"d:\Documents\WILDCODE\projet-3\2022-03-php-remote-1283-montbeliard-cite-libre\templates\registration\register.html.twig", "HTML (Twig)", 25, 0, 7, 32
"d:\Documents\WILDCODE\projet-3\2022-03-php-remote-1283-montbeliard-cite-libre\templates\score\index.html.twig", "HTML (Twig)", 12, 0, 5, 17
"d:\Documents\WILDCODE\projet-3\2022-03-php-remote-1283-montbeliard-cite-libre\templates\summary\index.html.twig", "HTML (Twig)", 18, 0, 6, 24
"Total", "-", 1623, 29, 245, 1897